Map:
------------
------------
------------
------------
------------
------------
------------
------------
------------
------------
------------
------------
------------
------------
------------
------------
------------
------------
000000000000
------------
------------
------------
------------
------------
---111111---
------------
Map/

Meta:
Unbreakable: 0
Powerup: 1
Meta/

Legend:
0) grey-block.png
1) orange-block.png
Legend/